{
	"terrain" : {
		"width": 257,
		"height": 12,
		"tiles": [
"0000000000000000000000000000000000000000000000000000000000000000000000000000000000000000000000000000000000000000000000000000000000000000000000000000000000000000000000000000000000000000000000000000000000000000000000000000000000000000000000000000000000000000",
"0000000000000000000000000000000000000000000000000000000000000000000000000000000000000000000000000000000000000000000000000000000000000000000000000000000000000000000000000000000000002020000000000000000000000000000000000000000000000000000000000000000000000000",
"0000000000000000000000000000000000000000000000000000000000000000000000000000000000000000000000000000000000000000000000000000000000000000000000000000000000000000000000000000000000000000000000000200200000000011111100111111001111110011111100100000001111110000",
"0000000000000000000000000000000000000000000000000000000000000000000000000000000000000000000000000000000000000000000000000000000000000000000000000000000000000000000000000000000000100000010000000000000000000010200000100201001002010010200000100000001000000000",
"0000000000000000000000000000000000000000000000000002000000000000000000000000002000000000000000000000000000000000000000000111000111000000000000000000000000000000000011100000000000111111110000010000001000000010001100100001001000010010001100100000001111110000",
"0000000000000000000000000000000000000000000000000000000000000000000000000200000000000000000000000000000000000000000000011100000000000000202020200000000000000000001110000001100000000000000000011111111000000010000100100001001000010010000100100000001000000000",
"0000000000000000000000000000001111000000000000200100010000000000000002000001000100000000000000000000000000020020000001110000000000000000000000000000000000000000111000000001111000000000000000000000000000000011111100111111001111110011111100111111001111110000",
"0000000000000000000000000000011000000000000020000111110000000000020000010001111100000000000000000000000000000000000111000000000000000001000000010000000000000011100000000001111110000000000000000000000000000000000000000000000000000000000000000000000000000000",
"0000001100200200020000000001110020000000000000011111110000000000000100011111111100000002000020000000000001000001000000002000200200000201111111110001100200011102220002220001111111100002000200200020002000200002002000200020000200200200000200200200200020000000",
"0000011000000000000000001111000000000000000001111111110000000001000111111111111100000000000000000111111111111111000000000000000000000000000000000001100001111000000000000001111111111000000000000000000000000000000000000000000000000000000000000000000000000000",
"0000110000000000000000111110000000000000000111111111110000000001111111111111111100000000000000000111111111111111000000000000000000000000000000000001100001111000000000000001111111111110000000000000000010000000000000000000100000000001110000000000001000400100",
"3333333333333333333333333333333333333333333333333333333333333333333333333333333333333333333333333333333333333333333333333333333333333333333333333333333333333333333333333333333333333333333333333333333333333333333333333333333333333333333333333333333333333333"
		 ]
	}
}