{
	"terrain" : {
		"width": 250,
		"height": 12,
		"tiles": [
"0000000000000000000000000000000000000000000000000000000000000000000000000000000000000000000000000000000000000000000000000000000000000000000000000000000000000000000000000000000000000000000000000000000000000000002000200000000000000000000000000000000000",
"0000000000000000000000000000000000000000000000000000000000000000000000000000000000000000000000000000000000000000000000000000000000000000000000000000000000000000000000000000000000000000000000000000000000000000000000000000000000000000000000000000000000",
"0000000000000000000000000000000000000000000000000000000000000000000000000000000000000000000000000000000000000000000000000000000000000000200200000000000000000000000000000000000000000000000000000000000000000000100000010000000020000000000000000000000000",
"0000000000000000000000000000000000000000000020000000000000000000000000000000000000000000000000000000000000000000000000000000000000000000000000000000000000000000000000000000000000000000000000000000000000000000111111110000000000000000000000000000000020",
"0000000000000000000000000000000000000000000000000000000000000000002000000000000000000000000000020000000000000000000000000000000000000000001111111110000000000000000000000000000000000111000000000001111111100000000000000000010000010000000202000000000000",
"0000000000000000000000000000000000000000000000001000000000000000000000000000000000000000000200000100000000000000000000000000000000000000111000000000000000002000000000000000000000011100000001100000000000000000000000000000011111110000000000000000001004",
"0000000000000000000000000000000000000000000011111000000000000000100010000000000000000002000001000100000000000000000000000000020020000011100000000000000000000000000000000000000001110000000001111000000000000000000000000000000000000000010000010000111111",
"0000000000000000000000000000000000000000000110000000000000000000111110000000000000020000010001111100000000000000000000000000000000001110000000000000000000000000000000000000000111000000000001111110000000000000000000000000000000000000011111110000111111",
"0000000000000000001000000200200000020000001110000000020000000001111111000000000000000100011111111100000020000200000000000001000001000000002000200200000201111111110001100000011102220002220001111111100002000200000020002000200002000020000020000000111111",
"0000000000000001100000000000000000000000011110000000000000000011111111100000000001000111111111111100000000000000000111111111111111000000000000000000000000000000000001100001111000000000000001111111111000000000000000000000000000000000000000000000111111",
"0000000000000010000000000000000000000000111110000000000000000111111111110000000001111111111111111100000000000000000111111111111111000000000000000000000000000000000001100001111000000000000001111111111110000000000000000000000000000000000000000000111111",
"3333333333333333333333333333333333333333333333333333333333333333333333333333333333333333333333333333333333333333333333333333333333333333333333333333333333333333333333333333333333333333333333333333333333333333333333333333333333333333333333333333333333"
		 ]
	}
}