{
	"terrain" : {
		"width": 250,
		"height": 12,
		"tiles": [
"0000000000000000000000000000000000000000000000000000000000000000000000000000000000000000000000000000000000000000000000000000000000000000000000000000000000000000000000000000000000000000000000000000000000000000000000000000000000000000000000000000000000",
"0000000000000000000000000000000000000000000000000000000000000000000000000000000000000000000000000000000000000000000000000000000000000000000000000000000000000000000000000000000000000000000000000000000000000000000000000000000000000000000000000000000000",
"0000000000000000000000000000000000000000000000000000000000000000000000000000000000000000000000000000000000000000000000000000000000000000200200000000000000000000000000000000000000000000000000000000000000000000000000000000000000000000000000000000000000",
"0000000000000000000000000000000000000000000020000000000000000000000000000000000000000000000000000000000000000000000000000000000000000000000000000000000000000000000000000000000000000000000000000000000000000000000000000000000000000000000000000000000000",
"0000000000000000000000000000000000000000000000000000000000000000000000000000000000000000000000020000000000000000000000000000000000000000001111111110000000000000000000000000000000000111000000000000000000000000000000000000000000000000000000000000000000",
"0000000000000000000000000000000000000000000000001000000000000000000000000000000000000000000200000100000000000000000000000000000000000000111000000000000000002000000000000000000000011100000001100000000000000000000000000000000000000000000000000000000000",
"0000000000000000000000000000000000000000000011111000000000000000000000000000000000000002000001000100000000000000000000000000020020000011100000000000000000000000000000000000000001110000000001100000000000000000000000000000000000000000000000000000000000",
"0000000000000000000000000000000000000000000110000000000000000000000000000000000000020000010001111100000000000000000000000000000000001110000000000000000000000000000000000000000111000000000001100000000000000000000000000000000000000000000000000000000000",
"0000000000000000001000000000000000000000001110000000000000000000000000000000000000000100011111111100000020000200000000000001000001000000002000200200000201111111110001100000011102220002220001100000000000000000000000000000000000000000000000000000000000",
"0000000000000001100000000000000000000000011110000000000000000000000000000000000001000111111111111100000000000000000111111111111111000000000000000000000000000000000001100001111000000000000001100000000000000000000000000000000000000000000000000000000000",
"0000000000000010000000000200200000020000111110000000020000000102000000100000000001111111111111111100000000000000000111111111111111000000000000000000000000000000000001100001111000000000000001100000000000000000000000000000000000000000000000000000000000",
"3333333333333333333333333333333333333333333333333333333333333333333333333333333333333333333333333333333333333333333333333333333333333333333333333333333333333333333333333333333333333333333333333333333333333333333333333333333333333333333333333333333333"
		 ]
	}
}